############################
#............##............#
#.####.#####.##.#####.####.#
#o####.#####.##.#####.####o#
#..........................#
#.####.##.########.##.####.#
#......##....##....##......#
######.##### ## #####.######
######.##          ##.######
######.## ###--### ##.######
#     .   #      #   .     #
######.## ######## ##.######
######.##          ##.######
######.## ######## ##.######
#............##............#
############################